X---X---------------------------X
X                               |
|    Mnn                        |
|    nnn                        |
|                 Pn            |
|                               |
|                               |
X-------------------------------X