X---X---------------------------X
X                               |
|    Mnn                        |
|    nnn                        |
|                 Pnn           |
|                 nnn           |
|                               |
X-------------------------------X